

NO ./texture/bookshelf.xpm
SO ./texture/kamecci.xpm
WE ./texture/tails.xpm
EA ./texture/42_logo.xpm

F 43,139,87
C 135,206,235

11111111111111111
10330000000000001
10400000000000001
10000000000000001
100000N0000000001
10000000000000001
10000000000000001
10000000000000001
11111111111111111