
NO ./texture/sonic.xpm
SO ./texture/teapot.xpm
WE ./texture/tails.xpm
EA ./texture/planks.xpm

F 43,139,87
C 135,206,235

111111111111111 1111
111111000111111 1011
111110000011111 1111
111100000001111
111000000000111
1100000N0000011
100001111100001
110000111000011
111000010000111
111100000001111
111110000011111
111111000111111
111111111111111


