NO ./texture/sonic.xpm
SO ./texture/teapot.xpm
WE ./texture/tails.xpm
EA ./texture/planks.xpm

F 46,139,87
C 135,206,235

111111111   
110111111
100000001
10N010001
100101001   
100010001 
100000001
100000001   
111111111    
